type octile
height 81
width 65
map
TTTTTTTTTTTTTTTTTTTTTTTTTTTTTTTTTTTTTTTTTTTTTTTTTTTTTTTTTTTTTTTTT
TTTTTTTTTTTTTTTTTTTTTTTTTTTTTTTTTTTTTTTTTTTTTTTTTTTTTTTTTTTTTTTTT
TTTTT.TTTTT.TTTTTTT.........TTTTTTTTTTTTTTTTTTTTTTTTTTTTTTTTTTTTT
TTTT........TTTTTT..........TTTTTTTTTTTTTTTTTTTTTTTT....TTTTTTTTT
TTTT........TTTTTTT.........TTTTTTTTTTTTTTTTTTTTTTTT...TTTTTTTTTT
TTT.........TTTTTTT..........TTTTTTTTTTTTTTTTTTTTT..........TTTTT
TTT........TTTTTTTT..........TTTTTTTTTTTTTTTTTTTTT..........TTTTT
TT.........TTTTTTTT..........TTTTTTTTTTTTTTTTTTTTT..........TTTTT
TT.........TTTTTTT...........TTTTTTT...TTTT...TTTT............TTT
TT.........TTTTTTTTT.........TTTTTTT....TTT...TTT.............TTT
TT.........TTTTTTTTT..........TTTT............................TTT
TTT............TTTTT..........................................TTT
TTT............TTTT...........................................TTT
TTT............TTTT..........................................TTTT
TT.............TTTT...........TTTTT....TTT.....TTT....TTTTTTTTTTT
TTTT...........TTTT.........TTTTTTTTTTTTTTTTTTTTTTTTTTTTTTTTTTTTT
TTTT.TTTT.....TTTTTT........TTTTTTTTTTTTTTTTTTTTTTTTTTTTTTTTTTTTT
TTTT.TTTT....TTTTTTT........TTTTTTTTTTTTTTTTTTTTTTTTTTTTTTTTTTTTT
TTTT.TTTT....TTTTT...........TTTTTTTTTTTTTTTTTTTTTTTTTTTTTTTTTTTT
TTTT.TTTT....................TTTTTTT....TTTTTTTTTTT........TTTTTT
TTTT.........................TTTTTTT....TTTTTTTTTTT.....TTTTTTTTT
TTTT.........................TTTTT......TTTTTTTTTTT.....TTTTTTTTT
TTT..........TTTTTT..........TTTTT......TTTTTTTTTTT.....TTTTTTTTT
TTT..........TTTTTT..........TTTTT......TTTTTTTTTTT.....TTTTTTTTT
TTT.TTTTTTTTTTTTTTT..........TTTTTT....TTTTTTTTTTTT.....TTTTTTTTT
TT..TTTTTTTTTTTTTTT..........TTTTTT....TTTTTTTTTTTT.....TTTTTTTTT
TT..TTTTTTTTTTTTTTT...........TTTT.....TTTTTTTTTTTT.....TTTTTTTTT
TT..TTTTTTTTTTTTTTT.....................................TTTTTTTTT
TT..TTTTTTTTTTTTTTT.....................................TTTTTTTTT
TT..TTTTTTTTTTTTTTT...........................................TTT
TTTTTTTTTTTTTTTTTTT...........TTTT............................TTT
TTTTTTTTTTTTTTTTTTT...........TTTTTTTTTTTTTTTTTTTTTTTTTTTTTTTTTTT
TTTTTTTTTTTTTTTTTTT...........TTTTTTTTTTTTTTTTTTTTTTTTTTTTTTTTTTT
TTTTTTTTTTTTTTTTTT............TTTTTTTTTTTTTTTTTTTTTTTTTTTTTTTTTTT
TTTTTTTTTTTTTTTTTT............TTTTTTTTTTTTTTTTTTTTTTTTTTTTTTTTTTT
TTTTTTTTTTTTTTTTTT.................TTTTTTTTTTTTTTTTTTTTTTTTTTTTTT
TTTTTTTTTTTTTTTTTT.................TTTTTTT....TTTTTTT.TTTTTTTTTTT
TTTTTTTTTTTTTTTTTT.....................TTT.....TTT.............TT
TTTTTTTTTTTTTTTTTTT............................................TT
TTTTTTTTTTTTTTTTTTT...........................................TTT
TTTTTTTTTTTTTTTTTTT...........................................TTT
TTTTTTTTTTTTTTTTTTT...........................................TTT
TTTTTTTTTTTTTTTTTTT..........................................TTTT
TTTTTTTTTTTTTTTTTTTT..................TTTTTTTTT..............TTTT
TTTTTTTTTTTTTTTTTTTT..................TTTTTTTTT..............TTTT
TTTTTTTTTTTTTTTTTTTT..TTTT.....TTT..TTTTTTTTTTT...............TTT
TTTTTTTTTTTTTTTTTTTTTTTTTTT...TTTTTTTTTTTTTTTTTTTTT...TTTTTTTTTTT
TTTTTTTTTTTTTTTTTTTTTTTTTTT...TTTTTTTTTTTTTTTTTTTTT...TTTTTTTTTTT
TTTTTTTTTTTTTTTTTTTTTTTTTTT...TTTTTTTTTTTTTTTTTTTTT...TTTTTTTTTTT
TTTTTTTTTTTTTTTTTTTTTTTTTTT...TTTTTTTTTTTTTTTTTTTTTT..TTTTTTTTTTT
TTTTTTTT.TTTTTTT.TTTTTTTTT.....TTTTTTTTT.TTTTTTTTTT......TTTTTTTT
TTTTTTTT.TTTTTTT.TTTTTTT..........TTTTTT.TTTTTTTTTT......TTTTTTTT
TTTTTTTT..TTTTTT.TTTTTTT..........TTTTTT.TTTTTTTTTT.......TTTTTTT
TTTT..TT..TTT.TT...TTT........................TTTTT.........TTTTT
TT............................................TTTTT.........TTTTT
TT............................................TTTTT........TTTTTT
TT............................................TTTTT........TTTTTT
TT...........TT.T.............................TTTT.........TTTTTT
TTT..TT......TTTT....TT.......................TTTT...........TTTT
TTT..TTTTT..TTTTT....TTTT.........TTTTTT.TTT..TTTT..........TTTTT
TTT..TTTTT...TTTT....TTTT.........TTTTTT.TTTT.TTTT............TTT
TTT..TTT.......TT...TTTT..........TTTTTT.TTTT.TTTT.....TTTTTT.TTT
TTT.................TTTTT.....TTTTTTTTTTTTTTT.TTTTTTTTTTTTTTTTTTT
TT....................TT....TTTTTTTTTTTTTTTTT.TTTTTTTTTTTTTTTTTTT
TTTTTTTTTTTTTT..............TTTTTTTTTTTTTTTTTTTTTTTTTTTTTTTTTTTTT
TTTTTTTTTTTTTT..............TTTTTTTTTTTTTTTTTTTTTTTTT.......TTTTT
TTTTTTTTTTTTTT................TTTT...........................TTTT
TTTTTTTTTTTTTT...............................................TTTT
TTTTTT.....TTT...............................................TTTT
TTTTTT.....TTT.................................................TT
TTTTT.....TTTT................TTTT.............................TT
TTTTT.....TTTT........TTT....TTTTT.............................TT
TTTTT.....TTTT........TTT....TTTTT.............................TT
TTTTT.....TTTT........TTTTTT..TTTT.............................TT
TTTTT.....TTTT........TTTTTT..TTTTTT...........................TT
TTTTT.....TTTT........TTTTTT..TTTTTT.............................
TTTTT............TTT..TTTTTT.TTTTTTT.............................
TTTTT...........TTTT..TTTTTTTTTTTTTT...TTTTTTTTTTTTTTTTTTT.......
TTTTT...........TTTT....TTTTTTTTTTTT...TTTTTTTTTTTTTTTTTTT.....TT
TTTTTTTTTTTTTTTTTTTTTTTTTTTTTTTTTTTTTTTTTTTTTTTTTTTTTTTTTTTTTTTTT
TTTTTTTTTTTTTTTTTTTTTTTTTTTTTTTTTTTTTTTTTTTTTTTTTTTTTTTTTTTTTTTTT
