type octile
height 64
width 64
map
TTT.TTTTTTTTTTTTTTT.TTTTTT.TTTTTTT.TTTTTTTTTTTTTT.TTTTTTT.TTTTTT
T.......T.......T.......T.......T.......T.......T.......T.......
T.......T.......T.......T.......T.......T.......T.......T.......
........T.......T.......T.......T.......T.......T.......T.......
T.......T.......T.......T.......T.......T.......T.......T.......
T.......................T.......T.......T.......T...............
T.......T.......T.......T.......T.......T.......T.......T.......
T.......T.......T.......................T...............T.......
T.TTTTTTTTTTT.TTTTTTT.TTT.TTTTTTT.TTTTTTTTTTTTT.TTTTTT.TT.TTTTTT
T.......T.......T.......T.......T.......T.......T.......T.......
T.......T.......T.......................T.......T.......T.......
T.......T.......T.......T.......T.......T.......T.......T.......
................T.......T.......T.......T...............T.......
T.......T.......T.......T.......T...............T.......T.......
T.......T.......T.......T.......T.......T.......T...............
T.......T.......T.......T.......T.......T.......T.......T.......
TTTTTTT.TTTTT.TTTTTTTTTTTTTTTT.TTTTTTTTTTTTTT.TTTTTTTTT.TTTTTT.T
T.......T.......T.......T.......T.......T.......T.......T.......
T.......T.......T.......T.......T...............T.......T.......
T.......T.......T.......T.......T.......T.......T.......T.......
........T.......T...............T.......T...............T.......
T.......T.......T.......T.......T.......T.......T.......T.......
T...............T.......T.......T.......T.......T.......T.......
T.......T.......T.......T.......T.......T.......T.......T.......
T.TTTTTTTT.TTTTTTTTTT.TTTTTTTT.TTTTTTT.TT.TTTTTTT.TTTTTTTTTTTTT.
T...............T.......T.......T.......T.......T.......T.......
T.......T.......T.......T.......T.......T.......T.......T.......
T.......T.......T.......T...............T.......T.......T.......
T.......T.......T.......T.......T.......T.......T.......T.......
........T.......T.......T.......T.......T.......T.......T.......
T.......T.......T.......T.......T.......T.......T...............
T.......T.......T...............T.......T.......T.......T.......
TTTTTTTTTTTTTTTTTT.TTTTTTTT.TTTTTTTTTTTTTTTTTTTTTTTTTTT.TT.TTTTT
T.......T.......T.......T.......T.......T.......T.......T.......
T.......T.......T.......T...............T.......T.......T.......
T.......T.......T.......T.......T.......T.......T.......T.......
T...............T...............T.......T.......T.......T.......
T.......T.......T.......T.......T.......T.......T...............
........T.......T.......T.......T...............T.......T.......
T.......T.......T.......T.......T.......T.......T.......T.......
TTTTTTT.TTTTTTTTTTTTTTTTTTT.TTTTTT.TTTTTTTTTTT.TTTTT.TTTTTTT.TTT
T.......T.......T.......T.......T.......T...............T.......
T.......T.......T.......................T.......T.......T.......
T.......T...............T.......T.......T.......T.......T.......
T.......T.......T.......T.......T.......T.......T.......T.......
T.......T.......T.......T.......T.......T.......T.......T.......
T...............T.......T.......T.......T.......T.......T.......
........T.......T.......T.......T.......T.......T.......T.......
TTTT.TTTT.TTTTTTTT.TTTTTTTTTTT.TTTTTTTTTTTTTTT.TTTTTTTTTTTTTTTTT
........T.......T.......T.......T.......T.......T.......T.......
T.......T.......T.......T.......T.......T.......T.......T.......
T.......T.......T.......T.......T.......T.......T.......T.......
T.......T.......T.......T.......T.......T.......T...............
T.......T.......T.......T.......T.......T.......T.......T.......
T.......T.......T.......T.......T.......T.......T.......T.......
T.......T.......................................T.......T.......
TTTTTTTTTTT.TTTTTTTTTTTTTTTTTTT.TTTTTTTTTTTTT.TTTTTTTTT.TTTTTTTT
T.......T.......T.......T.......T.......T.......T.......T.......
T.......................T.......T.......T.......T.......T.......
T.......T.......T...............T.......T.......................
T.......T.......T.......T.......T.......T.......T.......T.......
T.......T.......T.......T.......T.......T.......T.......T.......
........T.......T.......T.......T.......T.......T.......T.......
T.......T.......T.......T.......T...............T.......T.......
