type octile
height 84
width 11
map
TTTTTTTTTTT
T.........T
T.........T
T.........T
T.........T
T.........T
TT.TT.TT.TT
TT.TT.TT.TT
TT.TT.TT.TT
TT.TT.TT.TT
TT.TT.TT.TT
TT.TT.TT.TT
TT.TT.TT.TT
TT.TT.TT.TT
TT.......TT
TT.TT.TT.TT
TT.TT.TT.TT
TT.TT.TT.TT
TT.TT.TT.TT
TT.TT.TT.TT
TT.TT.TT.TT
TT.TT.TT.TT
TT.TT.TT.TT
TT.TT.TT.TT
TT.TT.TT.TT
TT.......TT
TT.TT.TT.TT
TT.TT.TT.TT
TT.TT.TT.TT
TT.TT.TT.TT
TT.TT.TT.TT
TT.TT.TT.TT
TT.TT.TT.TT
TT.TT.TT.TT
TT.TT.TT.TT
TT.TT.TT.TT
TT.......TT
TT.TT.TT.TT
TT.TT.TT.TT
TT.TT.TT.TT
TT.TT.TT.TT
TT.TT.TT.TT
TT.TT.TT.TT
TT.TT.TT.TT
TT.TT.TT.TT
TT.TT.TT.TT
TT.TT.TT.TT
TT.......TT
TT.TT.TT.TT
TT.TT.TT.TT
TT.TT.TT.TT
TT.TT.TT.TT
TT.TT.TT.TT
TT.TT.TT.TT
TT.TT.TT.TT
TT.TT.TT.TT
TT.TT.TT.TT
TT.TT.TT.TT
TT.......TT
TT.TT.TT.TT
TT.TT.TT.TT
TT.TT.TT.TT
TT.TT.TT.TT
TT.TT.TT.TT
TT.TT.TT.TT
TT.TT.TT.TT
TT.TT.TT.TT
TT.TT.TT.TT
TT.TT.TT.TT
TT.......TT
TT.TT.TT.TT
TT.TT.TT.TT
TT.TT.TT.TT
TT.TT.TT.TT
TT.TT.TT.TT
TT.TT.TT.TT
TT.TT.TT.TT
TT.TT.TT.TT
T.........T
T.........T
T.........T
T.........T
T.........T
TTTTTTTTTTT
