type octile
height 128
width 128
map
TTTTTTTTTTTTTTTTTTTTTTTTTTTTTTTTTTTTTTTTTTTTTTTTTTTTTTTTTTTTTTTTTTTTTTTTTTTTTTTTTTTTTTTTTTTTTTTTTTTTTTTTTTTTTTTTTTTTTTTTTTTTTTTT
T...........................................T...........................................T................................T......
T...........................................T...........................................T................................T......
T...........................................T...........................................T................................T......
T...........................................T...........................................T................................T......
T...........................................T...........................................T................................T......
T...........................................T...........................................T................................T......
T...........................................T...........................................T................................T......
T...........................................T...........................................T................................T......
T...........................................T...........................................T................................T......
T...........................................T...........................................T................................T......
TTTTTTTTTTTTTTTTTTTTTTTTTTTTTTTTTT..........T..........T..........T..........TTTTTTTTTTTT..........TTTTTTTTTTTT..........T......
T...........................................T..........T..........T...........................................T..........T......
T...........................................T..........T..........T...........................................T..........T......
T...........................................T..........T..........T...........................................T..........T......
T...........................................T..........T..........T...........................................T..........T......
T...........................................T..........T..........T...........................................T..........T......
T...........................................T..........T..........T...........................................T..........T......
T...........................................T..........T..........T...........................................T..........T......
T...........................................T..........T..........T...........................................T..........T......
T...........................................T..........T..........T...........................................T..........T......
T...........................................T..........T..........T...........................................T..........T......
T..........TTTTTTTTTTTTTTTTTTTTTTTTTTTTTTTTTT..........TTTTTTTTTTTTTTTTTTTTTTT..........TTTTTTTTTTTTTTTTTTTTTTT..........T......
T......................................................T..........T.....................T.....................T..........T......
T......................................................T..........T.....................T.....................T..........T......
T......................................................T..........T.....................T.....................T..........T......
T......................................................T..........T.....................T.....................T..........T......
T......................................................T..........T.....................T.....................T..........T......
T......................................................T..........T.....................T.....................T..........T......
T......................................................T..........T.....................T.....................T..........T......
T......................................................T..........T.....................T.....................T..........T......
T......................................................T..........T.....................T.....................T..........T......
T......................................................T..........T.....................T.....................T..........T......
T..........TTTTTTTTTTTTTTTTTTTTTTTTTTTTTTTTTTTTTTTTTTTTT..........T..........TTTTTTTTTTTT..........TTTTTTTTTTTT..........T......
T..........T......................................................T..........T................................T.................
T..........T......................................................T..........T................................T.................
T..........T......................................................T..........T................................T.................
T..........T......................................................T..........T................................T.................
T..........T......................................................T..........T................................T.................
T..........T......................................................T..........T................................T.................
T..........T......................................................T..........T................................T.................
T..........T......................................................T..........T................................T.................
T..........T......................................................T..........T................................T.................
T..........T......................................................T..........T................................T.................
T..........TTTTTTTTTTTTTTTTTTTTTTT..........TTTTTTTTTTTTTTTTTTTTTTT..........TTTTTTTTTTTTTTTTTTTTTTT..........T..........T......
T..........T.....................T.....................T.....................T..........T................................T......
T..........T.....................T.....................T.....................T..........T................................T......
T..........T.....................T.....................T.....................T..........T................................T......
T..........T.....................T.....................T.....................T..........T................................T......
T..........T.....................T.....................T.....................T..........T................................T......
T..........T.....................T.....................T.....................T..........T................................T......
T..........T.....................T.....................T.....................T..........T................................T......
T..........T.....................T.....................T.....................T..........T................................T......
T..........T.....................T.....................T.....................T..........T................................T......
T..........T.....................T.....................T.....................T..........T................................T......
T..........T..........T..........TTTTTTTTTTTT..........T..........TTTTTTTTTTTT..........TTTTTTTTTTTTTTTTTTTTTTTTTTTTTTTTTT......
T.....................T.....................T..........T..........T.....................T................................T......
T.....................T.....................T..........T..........T.....................T................................T......
T.....................T.....................T..........T..........T.....................T................................T......
T.....................T.....................T..........T..........T.....................T................................T......
T.....................T.....................T..........T..........T.....................T................................T......
T.....................T.....................T..........T..........T.....................T................................T......
T.....................T.....................T..........T..........T.....................T................................T......
T.....................T.....................T..........T..........T.....................T................................T......
T.....................T.....................T..........T..........T.....................T................................T......
T.....................T.....................T..........T..........T.....................T................................T......
TTTTTTTTTTTTTTTTTTTTTTTTTTTTTTTTTT..........T..........T..........TTTTTTTTTTTT..........T..........TTTTTTTTTTTT..........T......
T................................T.....................T..........T.....................T.....................T..........T......
T................................T.....................T..........T.....................T.....................T..........T......
T................................T.....................T..........T.....................T.....................T..........T......
T................................T.....................T..........T.....................T.....................T..........T......
T................................T.....................T..........T.....................T.....................T..........T......
T................................T.....................T..........T.....................T.....................T..........T......
T................................T.....................T..........T.....................T.....................T..........T......
T................................T.....................T..........T.....................T.....................T..........T......
T................................T.....................T..........T.....................T.....................T..........T......
T................................T.....................T..........T.....................T.....................T..........T......
T..........TTTTTTTTTTTTTTTTTTTTTTTTTTTTTTTTTT..........T..........T..........TTTTTTTTTTTT..........TTTTTTTTTTTT..........T......
T................................T.....................T..........T.....................T..........T..........T..........T......
T................................T.....................T..........T.....................T..........T..........T..........T......
T................................T.....................T..........T.....................T..........T..........T..........T......
T................................T.....................T..........T.....................T..........T..........T..........T......
T................................T.....................T..........T.....................T..........T..........T..........T......
T................................T.....................T..........T.....................T..........T..........T..........T......
T................................T.....................T..........T.....................T..........T..........T..........T......
T................................T.....................T..........T.....................T..........T..........T..........T......
T................................T.....................T..........T.....................T..........T..........T..........T......
T................................T.....................T..........T.....................T..........T..........T..........T......
T..........TTTTTTTTTTTT..........T..........TTTTTTTTTTTTTTTTTTTTTTT..........TTTTTTTTTTTTTTTTTTTTTTT..........T..........TTTTTTT
T..........T.....................T...........................................T................................T.................
T..........T.....................T...........................................T................................T.................
T..........T.....................T...........................................T................................T.................
T..........T.....................T...........................................T................................T.................
T..........T.....................T...........................................T................................T.................
T..........T.....................T...........................................T................................T.................
T..........T.....................T...........................................T................................T.................
T..........T.....................T...........................................T................................T.................
T..........T.....................T...........................................T................................T.................
T..........T.....................T...........................................T................................T.................
TTTTTTTTTTTT..........T..........T..........TTTTTTTTTTTTTTTTTTTTTTT..........T..........TTTTTTTTTTTTTTTTTTTTTTTTTTTTTTTTTT......
T.....................T..........T................................T..........T..........T.......................................
T.....................T..........T................................T..........T..........T.......................................
T.....................T..........T................................T..........T..........T.......................................
T.....................T..........T................................T..........T..........T.......................................
T.....................T..........T................................T..........T..........T.......................................
T.....................T..........T................................T..........T..........T.......................................
T.....................T..........T................................T..........T..........T.......................................
T.....................T..........T................................T..........T..........T.......................................
T.....................T..........T................................T..........T..........T.......................................
T.....................T..........T................................T..........T..........T.......................................
TTTTTTTTTTTT..........TTTTTTTTTTTTTTTTTTTTTTT..........T..........TTTTTTTTTTTT..........TTTTTTTTTTTT..........T..........TTTTTTT
T.....................T................................T...........................................T..........T.................
T.....................T................................T...........................................T..........T.................
T.....................T................................T...........................................T..........T.................
T.....................T................................T...........................................T..........T.................
T.....................T................................T...........................................T..........T.................
T.....................T................................T...........................................T..........T.................
T.....................T................................T...........................................T..........T.................
T.....................T................................T...........................................T..........T.................
T.....................T................................T...........................................T..........T.................
T.....................T................................T...........................................T..........T.................
T..........TTTTTTTTTTTT..........TTTTTTTTTTTT..........TTTTTTTTTTTT..........TTTTTTTTTTTT..........TTTTTTTTTTTTTTTTTTTTTTT......
T...........................................T.....................T.....................T.......................................
T...........................................T.....................T.....................T.......................................
T...........................................T.....................T.....................T.......................................
T...........................................T.....................T.....................T.......................................
T...........................................T.....................T.....................T.......................................
T...........................................T.....................T.....................T.......................................
